R 1280 720
NO ./path_to_the_north_texture
SO ./path_to_the_south_texture
WE ./path_to_the_west_texture
EA ./path_to_the_east_texture
S ./path_to_the_sprite_texture
F 220,100,0
C 225,30,0

               1
              101
           111101111
           100000001
          11000100011
         111S010100111
         1000001000001
111111111100000000000111111111111111111111111111111111111111111111111111
10000000000000010000000000000000000000000000000000000000000000000000000111
1011111111111001010011111111111111111111111011111111111110111111111111011
101       11000100011                     101           101          101
101        100000001                      101           101          101
101        111101111111111111111111111111110111         101          101
101           100000000000000000000000000000001      11110111        101
10111111111111111111111100111111111011011111101      10000001        101
1000000000000000000000000011      100001  111011111111011110111111111101
11111111111111111110111111111111111000011110000000000001  10000000000001
                  10000000000000000000000000111111111111  11111111111111
                  11111111111111111111111111