R 400 800
NO txt64-1.xpm
SO txt64-2.xpm
WE txt64-3.xpm
EA txt64-4.xpm
S sprt64.xpm
F 48,14,28
C 115,194,251

        1111111111111111111111111
        1000000000110000000002021
        101100000111000000000000111
        1001000000000020002000001
1111111110110000011100000000N0001
100000000011000001110111110111111
11110111111111011100000010001
11110111111111011101010012201
11000000110101011100000010001
10000000000000001100000010001
10000000000000001101010010001
1100000111010001111101111000111
11110111 1110001 101111010001
11111111 1111011 111111111111
            101
           110111111
           100000001
          11020100011
         1110010100111
         1000001000001
111111111100000000000111111111111111111111111111111111111111111111111111
10000000000000010020000000000000000000000000000000000000000000000000000111
1011111111111001010011111111111111111111111011111111111110111111111111011
101       11000100011                     101           101          101
101        100000001                      101           101          101
101        111101111111111111111111111111110111         101          101
101           100000000000000000000000000000001      11110111        101
10111111111111111111111100111111111011011111101      10000001        101
1000000000000000000000000011      100001  111011111111011110111111111101
11111111111111111110111111111111111000011110000000000001  10000000000001
                  10000000000000000000000000111111111111  11111111111111
                  11111111111111111111111111
