R 1200 1200

NO ./64.xpm
SO ./64.xpm
WE ./64.xpm
EA ./64.xpm
S ./sprite.xpm
F 220,100,0
C 225,30,0

        1111111111111111111111111
        1000000000110000000000001
        1011000001110000002000001
        1001000000000000000000001
111111111011000001110000000000001
100000000011000001110111110111111
11110111111111011100000010001
11110111111111011101010010201
11000000110101011100000010001
10002000000000001100000010001
10000000000000001101010010001
11000001110101011111011110N0111
11110111 1110101 101111010001
11111111 1111111 111111111111
            101
           110111111
           100000001
          11000100011
         1110010100111
         1000001000001
111111111100000000000111111111111111111111111111111111111111111111111111
10000000000000010000000000000000000000000000000000000000000000000000000111
1011111111111001010011111111111111111111111011111111111110111111111111011
101       11000100011                     101           101          101
101        100000001                      101           101          101
101        111101111111111111111111111111110111         101          101
101           100000000000000000000000000000001      11110111        101
10111111111111111111111100111111111011011111101      10000001        101
1000000000000000000000000011      100001  111011111111011110111111111101
11111111111111111110111111111111111000011110000000000001  10000000000001
                  10000000000000000000000000111111111111  11111111111111
                  11111111111111111111111111