
R  7000 7000
 NO   txt64-1.xpm      

SO ./txt64-3.xpm   

     WE   txt64-2.xpm
EA txt64-4.xpm 

   S  sprt64-2.xpm   

 F  48,14,28 

C    115,194,251 

  1   1 1111111111111111111111111
    1   1000000000110000000002021
  1   1 101100000111000000200000111
        1001000000000020000000001
111111111011000001110000000010001
100000000011000001110111110111111
11110111111111011100000010001
11110111111111011101010010001
11000000110101011100000010001
10000000000000001100000010001
10000000000000001101010010001          1
1100000111010001111101111000111
11110111 1110001 101111010N01
11111111 1111111 111111111111
             1
            101
           110111111
           100000001
          11020100011
         1110010100111
         1000001000001
111111111100000000000111111111111111111111111111111111111111111111111111
10000000000000010020000000000000000000000000000000000000000000000000000111
1011111111111001010011111111111111111111111011111111111110111111111111011
101       11000100011                     101           101          101
101        100000001                      101           101          101
101        111101111111111111111111111111110111         101          101
101           100000000000000000000000000000001      11110111        101
10111111111111111111111100111111111011011111101      10000001        101
1000000000000000000000000011      100001  111011111111011110111111111101
11111111111111111110111111111111111000011110000000000001  10000000000001
                  10000000000000000000000000111111111111  11111111111111
                  11111111111111111111111111



